WWWWWWWWWWWWWWW
WYYYYYYYYYYYYYW
WYYYYYYWYYYYYYW
WYYWYYYYYYYWYYW
WYYYGYYYYYYYYYW
WYYWYYYYYYYWYYW
WYYYYYYYYYYWYYW
WYHYYYYYWYYYYYW
WWWWWWWWWWWWWWW
