WWWWWWWWWWWWWWWWWWWW
W.......W..W....WWWW
W..S.S.............W
W...S...W.WWWWWWWWWW
W..S.S.....S....WWWW
W....Z...S..S...WWWW
W.H............WWWWW
WWWWWWWWWWWWWWWWWWWW
