WWWWWWWWWWWWWWWW
W.......W..W.WWW
W..S.S.........W
W...S...W.W..WWW
W..S.S.....S.WWW
W....Z...S..SWWW
W.H..........WWW
WWWW..G.......WW
WW........WW..WW
WWW.WW.....WWWWW
WWWW....WW.WWWWW
WWW...G..G....WW
WWWW...WWW...WWW
WW....G.......WW
WW...........WWW
WWWWWWWWWWWWWWWW
