WWWWWWWWWWWWWWWW
W.......W..W.WWW
W..S.S.........W
W...S...W.W..WWW
W..S.S.....S.WWW
W....Z...S..SWWW
W.H..........WWW
WWWW..........WW
WW........WW..WW
WWW.WW.....WWWWW
WWWW....WW.WWWWW
WWW...........WW
WWWW...WWW...WWW
WW............WW
WW...........WWW
WWWWWWWWWWWWWWWW
