WWWWWWWWWWWWW
W           W
W           W
W  Z     Z  W
W   Z   Z   W
W           W
W     G     W
W           W
W   Z   Z   W
W  Z     Z  W
W H         W
W           W
WWWWWWWWWWWWW
