WWWWWWWWWWWWW
W           W
W           W
W  Z     Z  W
W   Z   Z   W
W Y Y YYY   W
W Y   G     W
W           W
W S Z   Z   W
W  Z     Z  W
W H         W
W           W
WWWWWWWWWWWWW
