WWWWWWWWWWWWW
W...........W
W...........W
W...Z...Z...W
W..ZG...GZ..W
W...........W
W..ZG...GZ..W
W...Z...Z...W
W.....H.....W
W...........W
WWWWWWWWWWWWW
